24 9
5 6 7 8 9 10 11 12 13 
4 20 19 18 17 25 15 14 81 
3 21 22 23 24 16 26 27 80 
2 33 32 31 30 29 28 79 77 
34 1 71 72 73 74 75 76 78 
35 36 70 69 68 67 66 64 63 
37 38 39 40 41 42 65 62 61 
48 49 45 44 43 53 54 57 60 
47 46 50 51 52 55 56 58 0 
