32 9
9 8 7 6 5 22 23 24 25 
10 12 13 14 21 4 27 26 43 
11 16 15 20 30 28 3 42 44 
17 18 19 31 29 40 41 2 45 
34 33 32 38 39 48 47 46 1 
35 36 37 50 49 75 74 73 72 
53 52 51 77 76 59 60 71 70 
54 55 56 78 58 61 64 66 69 
81 80 79 57 62 63 65 0 68
